011111111111111
100000001101101
100110000000011
101001101100101
101110000011001
111111111111110
